{
"width" : 30,
"height" : 20,
"tiles" : [[1,2,1,2,2,38,53,40,35,38,47,36,60,7,29,5,24,11,6,6],
	[1,2,1,1,1,38,47,36,32,43,40,35,18,7,4,5,49,19,19,59],
	[2,2,1,1,1,38,55,36,34,41,36,2,60,11,6,12,60,9,8,8],
	[61,2,1,2,1,38,30,36,2,38,36,2,22,19,19,59,23,7,3,3],
	[19,19,21,1,1,38,54,42,39,43,42,33,2,9,8,8,8,25,3,3],
	[8,10,60,1,32,43,40,37,37,41,53,36,1,7,4,4,4,4,4,28],
	[29,5,18,2,38,30,42,33,2,38,30,42,33,11,27,3,3,3,3,5],
	[4,5,24,2,45,44,44,46,2,45,44,44,46,2,11,6,6,27,3,5],
	[4,5,60,2,38,31,30,36,2,38,55,53,36,20,19,19,21,7,4,5],
	[6,12,18,2,38,30,30,36,2,38,54,54,36,60,13,2,60,7,4,5],
	[59,50,23,2,38,30,30,36,61,38,30,53,36,18,2,2,24,7,4,5],
	[10,60,1,2,38,30,40,35,2,34,41,30,36,60,2,20,23,7,4,5],
	[5,18,2,2,38,30,42,39,33,32,43,30,36,22,19,23,9,25,4,5],
	[5,60,1,32,43,30,30,30,42,43,30,30,36,2,9,8,25,4,4,26],
	[5,18,1,38,47,30,30,30,30,30,30,30,36,2,7,3,4,4,4,4],
	[12,24,1,45,44,44,44,44,44,44,44,44,46,9,25,3,3,28,6,6],
	[19,23,1,38,54,30,30,30,30,30,30,30,36,7,4,4,28,12,20,21],
	[1,2,2,34,41,31,30,30,30,30,30,30,36,7,4,28,12,20,23,60],
	[1,2,32,39,43,53,30,40,37,37,41,30,36,11,6,12,20,23,61,18],
	[39,57,43,30,30,30,30,42,39,39,43,55,36,2,2,2,24,2,2,18],
	[47,56,40,41,30,30,30,30,30,30,30,47,36,9,10,2,60,2,2,60],
	[41,56,36,38,30,30,30,30,30,30,30,53,36,7,26,10,22,21,13,18],
	[34,58,35,38,30,30,30,30,30,30,30,40,35,7,4,26,10,22,19,23],
	[1,1,1,45,44,44,44,44,44,44,44,46,2,11,6,27,26,8,10,2],
	[59,21,1,38,47,30,30,30,30,30,30,36,20,19,21,7,4,4,5,2],
	[61,18,1,34,41,30,30,30,30,30,30,36,60,2,24,11,27,4,26,8],
	[2,18,2,2,38,30,30,30,30,30,55,36,18,2,49,21,11,6,6,6],
	[19,52,21,1,38,30,30,30,30,30,54,36,18,2,18,22,19,59,19,21],
	[8,10,24,2,38,30,30,30,30,30,40,35,60,1,24,1,1,2,13,60],
	[29,5,60,1,38,30,30,30,30,30,36,1,22,19,52,19,19,19,19,23]]
}